...##.
..##.#....#
.##..###..#
#.....#...#
#...@..#..#
###..###..#
..#..#....#
.##.##.#.##
.#...#..##
.#......#
.#.#...#